4 13 31
###############################
#p    * **    *   1   2       #
# # # #*# # # # # # # # # # # #
#      ** * *  *   * ** 1 *   #
# # # # # #*# # # # # # #*# # #
#*   * *    *b* *   **        #
# # # # # # # # # # # # # #*# #
#    *     *        *    **  2#
# #*# # #*#*#*#*# # #1# # #*# #
#        * 1 *2*    *   *     #
#*# # # # # # # # # # #*# # #*#
#x*    * **    ** ***     1   #
###############################